#Day,Bajone,Campo,Cidade_De_Quelimane,Derre,Gonhane,Inhassunge,Macuze,Maganja,Maquival,Micaune,Mocuba,Mocubela,Namacurra,Nante,Nicoadala,Pebane
0,0,0,0,0,0,0,0,0,0,0,0,0,0,0,0,0
1,0,0,0,0,0,0,0,0,0,0,0,0,0,0,0,0
2,0,0,0,0,0,0,0,0,0,0,0,0,0,0,0,0
3,0,0,0,0,0,0,0,0,0,0,0,0,0,0,0,0
4,0,0,0,0,0,0,0,0,0,0,0,0,0,0,0,0
5,0,0,0,0,0,0,0,0,0,0,0,0,0,0,0,0
6,0,0,0,0,0,0,0,0,0,0,0,0,0,0,0,0
7,0,0,0,0,0,0,0,0,0,0,0,0,0,0,0,0
8,0,0,0,0,0,0,0,0,0,0,0,0,0,0,0,0
9,0,0,0,0,0,0,0,0,0,0,0,0,0,0,0,0
10,1,0,1,0,1,1,1,1,1,0,1,0,1,1,1,0
11,1,0,1,0,1,1,1,1,1,0,1,0,1,1,1,0
12,1,0,1,0,1,1,1,1,1,0,1,0,1,1,1,0
13,1,0,1,0,1,1,1,1,1,0,1,0,1,1,1,0
14,1,0,1,0,1,1,1,1,1,0,1,0,1,1,1,0
15,1,0,2,0,2,2,2,1,2,0,1,0,2,1,2,0
16,1,0,2,0,2,2,2,1,2,0,1,0,2,1,2,0
17,1,0,2,0,2,2,2,1,2,0,1,0,2,1,2,0
18,1,0,2,0,2,2,2,1,2,0,1,0,2,1,2,0
19,1,0,2,0,2,2,2,1,2,0,1,0,2,1,2,0
20,1,0,1,0,1,1,1,1,1,0,1,0,1,1,1,0
21,1,0,1,0,1,1,1,1,1,0,1,0,1,1,1,0
22,1,0,1,0,1,1,1,1,1,0,1,0,1,1,1,0
23,1,0,1,0,1,1,1,1,1,0,1,0,1,1,1,0
24,1,0,1,0,1,1,1,1,1,0,1,0,1,1,1,0
25,1,0,1,0,1,1,1,1,1,0,1,0,1,1,1,0
26,0,0,0,0,0,0,0,0,0,0,0,0,0,0,0,0
27,0,0,0,0,0,0,0,0,0,0,0,0,0,0,0,0
28,0,0,0,0,0,0,0,0,0,0,0,0,0,0,0,0
29,0,0,0,0,0,0,0,0,0,0,0,0,0,0,0,0
30,0,0,0,0,0,0,0,0,0,0,0,0,0,0,0,0
